5 6 5 6 5 6 5 6 5 6 5
3 4 1 1 1 1 1 1 1 3 4
5 6 1 1 1 1 1 1 1 5 6
3 4 1 1 1 1 1 1 1 3 4
5 6 1 1 1 1 1 1 1 5 6
3 4 1 1 1 1 1 1 1 3 4
5 6 1 1 1 1 1 1 1 5 6
3 4 1 1 1 1 1 1 1 3 4
5 6 1 1 1 1 1 1 1 5 6
3 4 1 1 1 1 1 1 1 3 4
5 6 3 4 3 4 3 4 3 4 3