4 3 4 3 4 3 4 3 4 3 4 3 4 3 4 3 4 3 4 3 4 3 4 3 4 3 4 3 4 3 4 3 4 3
6 5 6 5 6 5 6 5 6 5 6 5 6 5 6 5 6 5 6 5 6 5 6 5 6 5 6 5 6 5 6 5 6 5
4 3 4 3 4 3 4 3 4 3 4 3 4 3 4 3 4 3 4 3 4 3 4 3 4 3 4 3 4 3 4 3 4 3
6 5 6 5 6 5 6 5 6 5 6 5 6 5 6 5 6 5 6 5 6 5 6 5 6 5 6 5 6 5 6 5 6 5
4 3 4 3 4 1 1 1 1 1 1 1 7 7 7 7 7 7 1 1 1 1 2 2 1 2 1 2 1 3 4 3 4 3
6 5 6 5 6 1 1 1 1 1 1 1 7 7 7 7 7 7 1 1 1 2 2 1 1 2 1 2 2 5 6 5 6 5
4 3 4 3 4 1 1 1 1 1 1 1 8 8 1 1 7 7 1 1 1 1 1 2 2 3 4 2 1 3 4 3 4 3
6 5 6 5 6 1 1 1 1 1 1 1 8 8 1 1 7 7 1 1 1 2 2 1 2 5 6 2 2 5 6 5 6 5
4 3 4 3 4 1 1 1 1 1 1 1 7 7 1 1 7 7 1 1 1 1 2 2 2 1 2 2 1 3 4 3 4 3
6 5 6 5 6 7 7 8 8 7 7 7 7 7 1 1 7 7 1 1 1 2 2 1 2 2 2 1 2 5 6 5 6 5
4 3 4 3 4 7 7 8 8 7 7 7 7 7 1 1 7 7 1 3 4 1 1 1 1 1 1 1 1 3 4 3 4 3
6 5 6 5 6 7 7 1 1 1 1 1 1 1 1 1 8 8 1 5 6 1 1 1 1 1 1 1 1 5 6 5 6 5
4 3 4 3 4 7 7 1 1 1 1 3 4 1 1 1 8 8 1 1 1 1 1 1 1 3 4 1 1 3 4 3 4 3
6 5 6 5 6 7 7 1 1 1 1 5 6 1 1 1 7 7 7 7 1 1 1 1 1 5 6 1 1 5 6 5 6 5
4 3 4 3 4 7 7 1 1 1 1 1 1 1 1 1 7 7 7 7 1 1 1 1 1 1 1 1 1 3 4 3 4 3
6 5 6 5 6 7 7 1 1 1 1 1 1 1 3 4 1 1 7 7 1 1 1 1 1 1 1 1 1 5 6 5 6 5
4 3 4 3 4 7 7 1 1 1 1 1 1 1 5 6 1 1 7 7 7 7 8 8 7 7 7 7 7 3 4 3 4 3
6 5 6 5 6 7 7 1 1 1 1 1 1 1 1 1 1 1 7 7 7 7 8 8 7 7 7 7 7 5 6 5 6 5
4 3 4 3 4 7 7 1 1 1 1 1 1 1 1 1 1 1 1 1 1 1 1 1 1 1 1 7 7 3 4 3 4 3
6 5 6 5 6 7 7 1 1 1 2 1 1 1 1 1 2 1 2 2 1 1 1 1 1 1 1 7 7 5 6 5 6 5
4 3 4 3 4 7 7 1 1 2 2 2 1 1 1 1 2 2 1 1 1 1 1 1 1 7 7 7 7 3 4 3 4 3
6 5 6 5 6 7 7 1 2 2 2 2 2 1 1 1 1 1 2 1 1 1 1 1 1 7 7 7 7 5 6 5 6 5
4 3 4 3 4 7 7 1 1 2 2 2 1 1 2 1 2 1 1 1 1 1 1 1 1 7 7 1 1 3 4 3 4 3
6 5 6 5 6 7 7 1 1 1 2 1 1 1 2 1 1 2 1 1 1 7 7 8 8 7 7 1 1 5 6 5 6 5
4 3 4 3 4 7 7 1 1 1 1 1 1 1 1 2 1 1 1 1 1 7 7 8 8 7 7 1 1 3 4 3 4 3
6 5 6 5 6 7 7 1 1 1 1 1 1 1 1 1 2 1 1 1 1 7 7 1 1 1 1 1 1 5 6 5 6 5
4 3 4 3 4 7 7 7 7 7 7 7 7 7 7 7 7 7 7 7 7 7 7 1 1 1 2 2 2 3 4 3 4 3
6 5 6 5 6 7 7 7 7 7 7 7 7 7 7 7 7 7 7 7 7 7 7 1 1 1 2 2 2 5 6 5 6 5
4 3 4 3 4 3 4 3 4 3 4 3 4 3 4 3 4 3 4 3 4 3 4 3 4 3 4 3 4 3 4 3 4 3
6 5 6 5 6 5 6 5 6 5 6 5 6 5 6 5 6 5 6 5 6 5 6 5 6 5 6 5 6 5 6 5 6 5
4 3 4 3 4 3 4 3 4 3 4 3 4 3 4 3 4 3 4 3 4 3 4 3 4 3 4 3 4 3 4 3 4 3
6 5 6 5 6 5 6 5 6 5 6 5 6 5 6 5 6 5 6 5 6 5 6 5 6 5 6 5 6 5 6 5 6 5
4 3 4 3 4 3 4 3 4 3 4 3 4 3 4 3 4 3 4 3 4 3 4 3 4 3 4 3 4 3 4 3 4 3
6 5 6 5 6 5 6 5 6 5 6 5 6 5 6 5 6 5 6 5 6 5 6 5 6 5 6 5 6 5 6 5 6 5